11111111111111111
1X0000000000000X1
10000000000000001
10000000000000001
10000000000000001
10000000001000001
10000000000000001
10000001111C00001
10P00C01E00000001
10000001111000001
10000000000000001
10000000001000001
10000000001000001
10000000000000001
10000000000000001
1X0000000000000X1
11111111111111111
