111111111111
1EC0000000C1
1X0100000001
100100000001
100100000001
100100000001
100100000001
1001P0000001
100000000001
111111111111

