11111111111111111
1X10000000000C1X1
10100111000000001
10000000000000001
10100000000000101
1E100000000000101
10000000000000101
1C10000000000C101
10P00C00E000000C1
10000001C00000101
10000000110000001
10110000000000001
10000011110001101
10000E1X000000001
11101111110100111
100X000000000C001
11111111111111111
