11111111111111111
1X1C00000000C10X1
10000000000000001
10000000000001001
11001000001000001
11C01010000000001
10001000011010111
100C10000000000C1
100110000000000C1
1000000000E000111
10001000000C00001
1P0C0000000000001
111001000001000C1
10000000000000101
10000000000000101
1X1C000000000C1X1
11111111111111111
