1111111111111111111111
1CC1CCCCCC01000E000001
1001000100010000000001
10000001111101000C0001
10000C0000000100P00001
1C0100000C0001000000C1
1111111111111111111111
